{
    "notch": [
        "J"
    ],
    "map": {
        "a": "e",
        "b": "s",
        "c": "o",
        "d": "v",
        "e": "p",
        "f": "z",
        "g": "j",
        "h": "a",
        "i": "y",
        "j": "q",
        "k": "u",
        "l": "i",
        "m": "r",
        "n": "h",
        "o": "x",
        "p": "l",
        "q": "n",
        "r": "f",
        "s": "t",
        "t": "g",
        "u": "k",
        "v": "d",
        "w": "c",
        "x": "m",
        "y": "w",
        "z": "b"
    }
}