{
    "notch": null,
    "map": {
        "a": "z",
        "b": "o",
        "c": "u",
        "d": "e",
        "e": "s",
        "f": "y",
        "g": "d",
        "h": "k",
        "i": "f",
        "j": "w",
        "k": "p",
        "l": "c",
        "m": "i",
        "n": "q",
        "o": "x",
        "p": "h",
        "q": "m",
        "r": "v",
        "s": "b",
        "t": "l",
        "u": "g",
        "v": "n",
        "w": "j",
        "x": "r",
        "y": "a",
        "z": "t"
    }
}