{
    "notch": [
        "Z",
        "M"
    ],
    "map": {
        "a": "f",
        "b": "k",
        "c": "q",
        "d": "h",
        "e": "t",
        "f": "l",
        "g": "x",
        "h": "o",
        "i": "c",
        "j": "b",
        "k": "j",
        "l": "s",
        "m": "p",
        "n": "d",
        "o": "z",
        "p": "r",
        "q": "a",
        "r": "m",
        "s": "e",
        "t": "w",
        "u": "n",
        "v": "i",
        "w": "u",
        "x": "y",
        "y": "g",
        "z": "v"
    }
}