{
    "notch": null,
    "map": {
        "a": "r",
        "b": "d",
        "c": "o",
        "d": "b",
        "e": "j",
        "f": "n",
        "g": "t",
        "h": "k",
        "i": "v",
        "j": "e",
        "k": "h",
        "l": "m",
        "m": "l",
        "n": "f",
        "o": "c",
        "p": "w",
        "q": "z",
        "r": "a",
        "s": "x",
        "t": "g",
        "u": "y",
        "v": "i",
        "w": "p",
        "x": "s",
        "y": "u",
        "z": "q"
    }
}