{
    "notch": null,
    "map": {
        "a": "l",
        "b": "e",
        "c": "y",
        "d": "j",
        "e": "v",
        "f": "c",
        "g": "n",
        "h": "i",
        "i": "x",
        "j": "w",
        "k": "p",
        "l": "b",
        "m": "q",
        "n": "m",
        "o": "d",
        "p": "r",
        "q": "t",
        "r": "a",
        "s": "k",
        "t": "z",
        "u": "g",
        "v": "f",
        "w": "u",
        "x": "h",
        "y": "o",
        "z": "s"
    }
}