{
    "notch": null,
    "map": {
        "a": "n",
        "b": "t",
        "c": "z",
        "d": "p",
        "e": "s",
        "f": "f",
        "g": "b",
        "h": "o",
        "i": "k",
        "j": "m",
        "k": "w",
        "l": "r",
        "m": "c",
        "n": "j",
        "o": "d",
        "p": "i",
        "q": "v",
        "r": "l",
        "s": "a",
        "t": "e",
        "u": "y",
        "v": "u",
        "w": "x",
        "x": "h",
        "y": "g",
        "z": "q"
    }
}