{
    "notch": null,
    "map": {
        "a": "j",
        "b": "g",
        "c": "d",
        "d": "q",
        "e": "o",
        "f": "x",
        "g": "u",
        "h": "s",
        "i": "c",
        "j": "a",
        "k": "m",
        "l": "i",
        "m": "f",
        "n": "r",
        "o": "v",
        "p": "t",
        "q": "p",
        "r": "n",
        "s": "e",
        "t": "w",
        "u": "k",
        "v": "b",
        "w": "l",
        "x": "z",
        "y": "y",
        "z": "h"
    }
}