{
    "notch": null,
    "map": {
        "a": "q",
        "b": "y",
        "c": "h",
        "d": "o",
        "e": "g",
        "f": "n",
        "g": "e",
        "h": "c",
        "i": "v",
        "j": "p",
        "k": "u",
        "l": "z",
        "m": "t",
        "n": "f",
        "o": "d",
        "p": "j",
        "q": "a",
        "r": "x",
        "s": "w",
        "t": "m",
        "u": "k",
        "v": "i",
        "w": "s",
        "x": "r",
        "y": "b",
        "z": "l"
    }
}