{
    "notch": null,
    "map": {
        "a": "f",
        "b": "v",
        "c": "p",
        "d": "j",
        "e": "i",
        "f": "a",
        "g": "o",
        "h": "y",
        "i": "e",
        "j": "d",
        "k": "r",
        "l": "z",
        "m": "x",
        "n": "w",
        "o": "g",
        "p": "c",
        "q": "t",
        "r": "k",
        "s": "u",
        "t": "q",
        "u": "s",
        "v": "b",
        "w": "n",
        "x": "m",
        "y": "h",
        "z": "l"
    }
}