{
    "notch": null,
    "map": {
        "a": "e",
        "b": "j",
        "c": "m",
        "d": "z",
        "e": "a",
        "f": "l",
        "g": "y",
        "h": "x",
        "i": "v",
        "j": "b",
        "k": "w",
        "l": "f",
        "m": "c",
        "n": "r",
        "o": "q",
        "p": "u",
        "q": "o",
        "r": "n",
        "s": "t",
        "t": "s",
        "u": "p",
        "v": "i",
        "w": "k",
        "x": "h",
        "y": "g",
        "z": "d"
    }
}