{
    "notch": null,
    "map": {
        "a": "d",
        "b": "m",
        "c": "t",
        "d": "w",
        "e": "s",
        "f": "i",
        "g": "l",
        "h": "r",
        "i": "u",
        "j": "y",
        "k": "q",
        "l": "n",
        "m": "k",
        "n": "f",
        "o": "e",
        "p": "j",
        "q": "c",
        "r": "a",
        "s": "z",
        "t": "b",
        "u": "p",
        "v": "g",
        "w": "x",
        "x": "o",
        "y": "h",
        "z": "v"
    }
}