{
    "notch": null,
    "map": {
        "a": "u",
        "b": "q",
        "c": "n",
        "d": "t",
        "e": "l",
        "f": "s",
        "g": "z",
        "h": "f",
        "i": "m",
        "j": "r",
        "k": "e",
        "l": "h",
        "m": "d",
        "n": "p",
        "o": "x",
        "p": "k",
        "q": "i",
        "r": "b",
        "s": "v",
        "t": "y",
        "u": "g",
        "v": "j",
        "w": "c",
        "x": "w",
        "y": "o",
        "z": "a"
    }
}