{
    "notch": [
        "Z"
    ],
    "map": {
        "a": "v",
        "b": "z",
        "c": "b",
        "d": "r",
        "e": "g",
        "f": "i",
        "g": "t",
        "h": "y",
        "i": "u",
        "j": "p",
        "k": "s",
        "l": "d",
        "m": "n",
        "n": "h",
        "o": "l",
        "p": "x",
        "q": "a",
        "r": "w",
        "s": "m",
        "t": "j",
        "u": "q",
        "v": "o",
        "w": "f",
        "x": "e",
        "y": "c",
        "z": "k"
    }
}