{
    "notch": null,
    "map": {
        "a": "e",
        "b": "h",
        "c": "r",
        "d": "v",
        "e": "x",
        "f": "g",
        "g": "a",
        "h": "o",
        "i": "b",
        "j": "q",
        "k": "u",
        "l": "s",
        "m": "i",
        "n": "m",
        "o": "z",
        "p": "f",
        "q": "l",
        "r": "y",
        "s": "n",
        "t": "w",
        "u": "k",
        "v": "t",
        "w": "p",
        "x": "d",
        "y": "j",
        "z": "c"
    }
}