{
    "notch": [
        "Z",
        "M"
    ],
    "map": {
        "a": "j",
        "b": "p",
        "c": "g",
        "d": "v",
        "e": "o",
        "f": "u",
        "g": "m",
        "h": "f",
        "i": "y",
        "j": "q",
        "k": "b",
        "l": "e",
        "m": "n",
        "n": "h",
        "o": "z",
        "p": "r",
        "q": "d",
        "r": "k",
        "s": "a",
        "t": "s",
        "u": "x",
        "v": "l",
        "w": "i",
        "x": "c",
        "y": "t",
        "z": "w"
    }
}