{
    "notch": [
        "Z",
        "M"
    ],
    "map": {
        "a": "n",
        "b": "z",
        "c": "j",
        "d": "h",
        "e": "g",
        "f": "r",
        "g": "c",
        "h": "x",
        "i": "m",
        "j": "y",
        "k": "s",
        "l": "w",
        "m": "b",
        "n": "o",
        "o": "u",
        "p": "f",
        "q": "a",
        "r": "i",
        "s": "v",
        "t": "l",
        "u": "p",
        "v": "e",
        "w": "k",
        "x": "q",
        "y": "d",
        "z": "t"
    }
}