{
    "notch": null,
    "map": {
        "a": "p",
        "b": "e",
        "c": "z",
        "d": "u",
        "e": "o",
        "f": "h",
        "g": "x",
        "h": "s",
        "i": "c",
        "j": "v",
        "k": "f",
        "l": "m",
        "m": "t",
        "n": "b",
        "o": "g",
        "p": "l",
        "q": "r",
        "r": "i",
        "s": "n",
        "t": "q",
        "u": "j",
        "v": "w",
        "w": "a",
        "x": "y",
        "y": "d",
        "z": "k"
    }
}