{
    "notch": null,
    "map": {
        "a": "i",
        "b": "m",
        "c": "e",
        "d": "t",
        "e": "c",
        "f": "g",
        "g": "f",
        "h": "r",
        "i": "a",
        "j": "y",
        "k": "s",
        "l": "q",
        "m": "b",
        "n": "z",
        "o": "x",
        "p": "w",
        "q": "l",
        "r": "h",
        "s": "k",
        "t": "d",
        "u": "v",
        "v": "u",
        "w": "p",
        "x": "o",
        "y": "j",
        "z": "n"
    }
}