{
    "notch": null,
    "map": {
        "a": "e",
        "b": "n",
        "c": "k",
        "d": "q",
        "e": "a",
        "f": "u",
        "g": "y",
        "h": "w",
        "i": "j",
        "j": "i",
        "k": "c",
        "l": "o",
        "m": "p",
        "n": "b",
        "o": "l",
        "p": "m",
        "q": "d",
        "r": "x",
        "s": "z",
        "t": "v",
        "u": "f",
        "v": "t",
        "w": "h",
        "x": "r",
        "y": "g",
        "z": "s"
    }
}