{
    "notch": null,
    "map": {
        "a": "q",
        "b": "w",
        "c": "e",
        "d": "r",
        "e": "t",
        "f": "z",
        "g": "u",
        "h": "i",
        "i": "o",
        "j": "a",
        "k": "s",
        "l": "d",
        "m": "f",
        "n": "g",
        "o": "h",
        "p": "j",
        "q": "k",
        "r": "p",
        "s": "y",
        "t": "x",
        "u": "c",
        "v": "v",
        "w": "b",
        "x": "n",
        "y": "m",
        "z": "l"
    }
}