{
    "notch": null,
    "map": {
        "a": "j",
        "b": "v",
        "c": "i",
        "d": "u",
        "e": "b",
        "f": "h",
        "g": "t",
        "h": "c",
        "i": "d",
        "j": "y",
        "k": "a",
        "l": "k",
        "m": "e",
        "n": "q",
        "o": "z",
        "p": "p",
        "q": "o",
        "r": "s",
        "s": "g",
        "t": "x",
        "u": "n",
        "v": "r",
        "w": "m",
        "x": "w",
        "y": "f",
        "z": "l"
    }
}