{
    "notch": null,
    "map": {
        "a": "f",
        "b": "s",
        "c": "o",
        "d": "k",
        "e": "a",
        "f": "n",
        "g": "u",
        "h": "e",
        "i": "r",
        "j": "h",
        "k": "m",
        "l": "b",
        "m": "t",
        "n": "i",
        "o": "y",
        "p": "c",
        "q": "w",
        "r": "l",
        "s": "q",
        "t": "p",
        "u": "z",
        "v": "x",
        "w": "v",
        "x": "g",
        "y": "j",
        "z": "d"
    }
}